1111111111
1P000x00C1
1000110001
1C10CC01C1
1000110001
1C10CC01C111
10x0110x01001
1C10CC01C11
1x001100x1
1C000x00E1
1111011111