11111111
1P000001
10C00C01
10000001
10C00C01
10000001
10C00C01
10000001
10C00C01
10000001
10C00CE1
11111111