111111111111111
1P01000000100C1
1001Cx101010101
10010C101010101
1x01C01C1000101
10000C101111101
111111100000001
1000C1x01111111
1C0100000C000E1
111111111111111